absinth	apsinthiatum -ī, n.
academic-insignia	ōrnāmentum -ī, n.
achilles-tendon	tendō Achillis -ōnis, m.
adams-apple	pōmum Adami -ī, n.
adder	Vīpera berus -ī, m.
administration	administrātiō -ōnis, f.
administrativecourt	tribūnal administrātivum -ālis, n.
administrativelaw	iūs administrātivum -ris, n.
administrator2	prōcūrātor -ōris, m.
adrenalin	adrēnalīnum -ī, n.
aerialphotograph	aërophotographica imāgō -inis, f.
aerodynamic	aërodynamicus -ae, f.
aesthetics	aesthetica -ae, f.
agriculture	rēs rūstica -ei, f.
air-raid	incursiō aēronautica -ōnis, f.
air-traffic	commeātus aërius -ūs, m.
air-conditioning	īnstrūmentum aērī temperandō -ī, n.
aircraft	nāvis āeria -is, f.
airfield	statiō aëria -ōnis, f.
airing	ventilātio -ōnis, f.
airlift	subsidium aëre vectum -ī, n.
airline	societās aëronautica -ātis, f.
airliner	nāvis aëria vectōria -is, f.
airman	homō volaticus -inis, m.
airplane	aëria nāvis -is, f.
airport	aëriportus -ūs, m.
airstrip	aëriarum nāvium portūs temporatio -ōnis, f.
airway	via āeria -ae, f.
albatross	diomēdēa exulāns -ae, f.
album	album -ī, n.
alcohol	alcohol -is, n.
alcoholic-noun	homō alcoholi nimium dēditus -inis, m.
alcoholic-drink	ēbriaminum -ī, n.
alcoholism	alcoholismus -ī, m.
animal-kingdom	ūniversitas animālium -ātis, f.
anisette	anisatum -ī, n.
antelope	pygargus -ī, m.
antenna	antenna -ae, f.
antler	cornū cervīnum -ūs, n.
aorta	grandis vēna cordis -ae, f.
ape	simia -ae, f.
apogee	fastīgium orbis sīderis -ī, n.
appendix	(intestīnum) caecum -ī, n.
appointee	dēsignātus -ūs, m.
appointment	creātio -ōnis,
aperitif	pōtiō aper(i)tiva -ōnis, f.
aquatic-animals	aquatilium -ī, n.
aquiline-nose	nāsus aduncus -ī, m.
arabesque	ōrnāmentum Arabicum -ī, n.
arcade	porticus -ūs, f.
passageway	domus trānsitōria -ūs, f.
architrave	epistylium -ī, n.
archives	tabulae (v. tabellae) pūblicae -arum, f.
armadillo	dasypūs -podis, m.
art2	ars -is, f.
art-dealer	iconopōla -ae, m.
art-exhibit	expositio -ōnis, f.
art-gallery	iconopōlium -ī, n.
art-history	historia artium -ae, f.
art-nouveau	genus (pingendi) flōrāle -eris, n.
artery	artēria -ae, f.
artists-studio	(pictōris) pergola -ae f.
asteroid	asteroides -is, f.
astronomer	astrologus -ī, m.
astronomy	astronomia -ae, f.
astrophysics	astrophysice -es, f.
atavism	indolēs ingeniumque ab atavīs trāditum -ī, n.
atlas	atlas -antis, m.
aviary	aviārium -ī, n.
aviation	ars āeronautica -tis, f.
aviator	volāticus homo -inis, m.
azimuth	azimutum -ī, n.
baboon	cynocephalus -ī, m.
background	abscēdentia -ae, f.
backhand-strike	ictus inversus -ūs, m.
backhanded	supīnā manū pulsus -ūs, m.
backpack-rucksack	pēra -ae, f.
bacteria	bacterium -ī, n.
bacteriology	bacteriologia -ae, f.
badge	īnsigne -is, n.
badger	taxo -ōnis, m.
badminton	lūdus pilae pennātae (Badmintonicae) -ī, m.
bag	crumīna -ae, f.
bail-out	(avi) de caelō umbellā labor -ōris, m.
balancing-pole	baculus libratōrius -ī, m.
balcony	maenium -ī, n.
ball	globus -ī, m.
ball-catcher	captor -ōris, m.
ball-game	lūsus pilāris -ūs, m.
ball-player	lūsor -ōris, m.
balloon	follis aërius -is, m.
balloon-hotair	globus (v. follis) aërostaticus, aërostaton -ī, m.
airship	aërostatum -ī, n.
banister	epimēdion -ī, n.
bank	argentāria -ae, f.
bank-account	argentāria ratiō -ōnis, f.
bank-deposit	pecūniae dēpositae -ārum, f.
bank-statement	ratiōnes breviāriae -um, f.
bankbook	libellus comparsōrum -ī, m.
banker	mēnsārius -ī, m.
banking	argentāria -ae, f.
banking-house	mēnsa argentāria -ae, f.
bar-counter	abacus caupōnius -ī, m.
baracuda	sphyraena -ae, f.
barefoot	discalceātus -i, m.
barn	horreum -ī, n.
barn-owl	ulula flammeata -ae, f.
barrel	cūpa -ae, f.
bas-relief	caelātūra -ae, f.
base-baseball	statiō -ōnis, f.
base	basis -is, f.
base-of-pedestal	podium -ī, n.
baseball	basipila -ae, f.
baseball-bat	baculus -ī, m.
baseman	custōs (statiōnis) -ōdis, m./f.
basement	contignātiō (v. receptāculum) subterraneum -ōnis, f.
basilica	basilica -ae, f.
basketball	lūdus bascaudārius -ī, m.
bass	perca fluviātilis -ae, f.
bat-sports	clāva -ae, f.
bat	vespertīlio -ōnis, m.
bathing	lavātio -ōnis, f.
batter	battūtor -ōris, m.
battleship	nāvis longa -is, f.
beach2	acta ad nandum idōnea -ae, f.
beach-suit	vestis natātōria -is, f.
beachcomber	ērro v. cessātor in litore -ōnis/ōris m.
beacon	signum monitōrium -ī, n.
bead	globulus perforātus -ī, m.
beagle	parvus canis vēnāticus -is, m.
beaver	castor -oris, m.
beer-ale	ael indeclinable
beer	ael indeclinable
beer-bottledbeer	cervesia lagoenaria -ae, f.
beetle	scarabaeus -ī, m.
belt	cingulum -ī, m.
beltbuckle	cingulī fībula -ae, f.
beret	pīleus Vasconicus -ī, m.
anchorage	statiō nāvālis -ōnis, f.
best-seller	liber venditiōne praecellentissimus -ī, m.
bibliography	index librōrum -icis, m./f.
biceps	lacertus -ī, m.
big-dipper	Ursa Māior -ae, f.
beak	rostrum -ī, n.
billiard-ball	globulus eburneus -ī, m.
billiards	lūdus tudicularis -ūs, m.
binding	ligātūra librī -ae, f.
biogenetics	biogenetica -ae, f.
biographer	vītae (alicuius) scrīptor -ōris, m.
biography	vīta -ae, f.
biologist	animantium scientiae doctus -ī, m.
biology	animantium scientia -ae, f.
biosphere	biosphaera -ae, f.
bird-of-paradise	avis paradīsī -is, f.
bird-of-prey	avis rapāx (v. praedatrix) -is, f.
birthmark	genetīva nota -ae, f.
blackbird	merula -ae, f.
bladder	vēsīca ūrīnāria -ae, f.
blimp	magnus follis volāticus -is, m.
blindfold	pannus oculos obligans -ī, m.
blood-donor	sanguinis dōnātor -ōris, m.
blood-plasma	ūmor sanguinis -ōris, m.
blood-poisoning	venēficium sanguinis -ī, n.
blood-pressure	pressūra sanguinis -ae, f.
blood-serum	serum sanguinis -ī, n.
blood-vessel	vās sanguineum -āsis, n.
bloodhound	canis sanguinarius -is, m.
bloodstream	fluxus sanguinis -ūs, m.
blueprint	operum -ī, n.
boa	boa -ae, f.
boat	scapha -ae, f.
boat-liner	nāvis longa -is, f.
boat-house	casa scaphāria (v. barcāria) -ae, f.
boat-race	certāmen nāviculārum (v. nauticum) -inis, n.
boating	gestātio nāviculā -ōnis, f.
bobsled	sclodia gubernābilis -ae, f.
bomb	bomba -ae, f.
bomb-shelter	bellōrum latebra -ae, f.
bombardier	ballistārius aērius -ī, m.
bomber-airplane	aēroplānum bombiferum -ī, n.
bombing	aērius coniectus -ūs, m.
bone-marrow	medulla ossium -ae, f.
bonnet	mitra -ae, f.
book-bag	capsula scholastica -ae, f.
book-review	exīstimātiō librī -ōnis, f.
bookbinder	bibliopega -ae, m.
booklet	libellus -ī, m.
bookmark	discerniculum -ī, n.
bookseller	librārius -ī, m.
bookshop-bookstore	(taberna) librāria -ae, f.
boomerang	missile recellēns -is, n.
boot	ocrea -ae, f.
booth	taberna -ae, f.
bootjack	furca caligaria -ae, f.
excessive-drinking	perpōtātio -ōnis, f.
botanist	herbārium -ī, n.
botany	herbāria (ars) -is, f.
bound-book	liber compactus -ī, m.
boundary-line	linea externa (campī) -ae, f.
bouquet-of-wine	flos odōris -ōris, m.
bowling-ball	globulus lūsōrius -ī, m.
bowling-lane	cōnōrum aureola -ae, f.
bowling-pin	cōnus -ī, m.
bowling	conilūdium -ī, n.
bowls-game	pilārum ligneārum lūdus -ī, m.
boxer	pugil -ilis, m.
boxing	pugilātus -ūs, m.
boxing-glove	caestus -ūs, m.
boxing-ring	suggestus quadrātus -ūs, m.
boy-scout	puer (v. adulēscēns) explōrātor -ī, m.
bracelet	armilla ae, f.
brand	stigma -ātis, n.
brandy	vīnum sublimatum -ī, n.
breakwater-mole	mōlēs (fluctibus opposita) -is, f.
breast-stroke	natātio prōna -ōnis, f.
breastbone-sternum	sternum -ī, n.
breed	seminium canīnum -ī, n.
breeding-selective	sēlectio (generatōria) -ōnis, f.
brewer	coctor (cervesiae) -ōris, m.
brewery	bracina -ae, f.
brewing	cerevisiae coctura -ae, f.
bridge	puppis -is, f.
briefcase	chartophylacium -ī, n.
broach	fībula -ae, f.
broad-jump-long-jump	saltus in longum -ūs, m.
brochure-pamphlet	libellus -ī, m.
bronchial-tubes	artēriae (asperae) -ārum, f.
bronchitis	spīritūs meātum inflammātio -ōnis, f.
bronco	mannus -ī, m.
brush	penicillum -ī, n.
buck-deer	cervus -ī, m.
buckle	fibula -ae, f.
buffalo	būbalus -ī, m.
bug	cīmex -icis, m.
bulls-eye-hit	scopus medius -ī, m.
bulldog	canis molossus -is, m.
bumblebee	apis bombitāns (v. orterrestris) -is, f.
buoy	signum innatāns ad nāvium cursus signāndos -ī, n.
buoyancy	levitās -ātis, f.
bureaucracy	grapheocratica -ae, f.
bureaucrat	grapheocrates -is, m.
burro	asinus -ī, m.
bust-bosom	pectus -oris, n.
bust	herma -ae, f.
butress	erisma -ae, f.
buzzard	būteo -ōnis, m.
cabin	cubiculum -ī, n.
cabinet	cōnsistorium -ī, n.
caliph	chalīfa -ae, f.
caliphate	chalīfatus -ūs, m.
camel-driver	camēlarius -ī, m.
caemo	camaeus -ī, m.
cameo	camaeus -ī, m.
cameraman	rei cinematographicae artifex phrase
canary	fringilla canāria -ae, f.
canoe	scapha -ae, f.
canvas	textile -is, n.
cap	pilleus -ī, m.
capital-arch	capitulum -ī, n.
capital-column	capitulum -ī, n.
capricorn	capricornus -ī, m.
captain	magister (v. praefectus) nāvis -ī, m.
carat	pars vīcēsima quārta aurī purī -ae, f.
caravansary	dēversōrium pūblicum -ī, n.
cargo-ship	(nāvis) onerāria -is, f.
caricature	dēprāvata imitātiō -ōnis, f.
caricaturist	gryllographus -ī, m.
carp	cyprinus -ī, m.
carrier-pigeon	columba vectōria -ae, f.
cartilage	cartilāgo -inis, f.
carving-art	caelātūra -ae, f.
carving-object	caelatūra -ae, f.
casement-window	biforis fenestra -ae, f.
castaway	naufragus -ī, m.
cat	cattus -ī, m.
catamaran	scapha Indica -ae, f.
cell	cellula -ae, f.
cell-fusion	cytogamia -ae, f.
celluloid	celluloīda -ae, f.
cellulose	cellulosa membrāna -ae, f.
censorship	censūra (librōrum) -ae, f.
chameleon	chamaeleon -ontis, m.
chamois	capreolus -ī, m.
chancellor	cancellarius -ī, m.
chapter	caput -itis, n.
charcoal	carbunculus -ī, m.
cheekbone	ōs mandibulae -is, n.
cheetah	lycāon -ōnis, f.
chimney-passage	fūmariolum -ī, n.
chimpanzee	satyrus -ī, m.
chipmunk	sciūrus Americanus -ī, m.
chlorophyll	chlorophyllum -ī, n.
chrosome	chromosōma -atis, n.
chrysalis	chrysallis -idis, f.
cicada	cicāda -ae, f.
cider-apple	vīnum mālinum -ī, n.
civilservice	officium cīvīle -ī, n.
cleft-palate	rictus lupīnus -ūs, m.
clipper	celōx ōcis, f.
clippings	resegmina -um, n.
clitoris	clitoris -idis, f.
clone	clōn -ōnis, m.
cloven-hoof	biscula ungula -ae, f.
club	fūstis -is, m.
co-pilot	volāticus adiūtor -ōris, m.
coaster	nāvis orāria -is, f.
coat-animal	pellis -is, f.
cobra	nāia -ae, f.
cock-rooster	gallus -ī, m.
cockatoo	psittacus cristātus -ī, m.
cockpit	aëroplanigae cella -ae, f.
cockroach	blatta -ae, f.
cocktail	cinnus -ī, m.
cocoon	globulus -ī, m.
cod	gadus morrhua -ī, m.
cognac	pōtiō Condatina (v. Coniacensis) -ōnis, f.
cold-disease	gravēdō -inis, f.
collar	collare -is, n.
collarbone	iugulum -ī, n.
collie	canis pāstōrālis -is, m.
colon	cōlon -ī, n.
colonnade	porticus -ūs, f.
column	caput -itis, n.
column-arch	columna -ae, f.
combine	mestrum tritorium -ī, n.
comet	comēta -ae, f.
comic-book	picta historiola -ae, f.
committee	dēlecti (viri) -ōrum, m.
compass-magnetic	nautica pyxis -idis, f.
compound-interest	anatocismus -ī, m.
concord-jet	aëronavis Concordiensis -is, f.
conditioned-reflex	reflexus condiciōnālis -ūs, m.
conference-hall-meeting-room	senāculum -ī, n.
connoisseur	exīstimātor -ōris, m.
greenhouse	hortus sub vitrō clausus -ī, m.
control-tower	turris speculātoria -is, f.
coping	corōna -ae, f.
copperplate-engraver	chalcographus -ī, m.
copperplate-engraving	chalcographia -ae, f.
copyright	iūs auctōrum -ūris, n.
corn	callus -ī, m.
cornea	(tunica) cornea -ae, f.
cornerstone	lapis angularis -idis, m.
cornice	corōna -ae, f.
coronary-arteries	artēriae corde tractae -ārum, f.
cougar	panthēra -ae, f.
court	ātrium -ī, n.
courtyard	ārea -ae, f.
cover	librī tegmen (v. tegumentum) -inis, n.
cow-milk	bōs lactaria -ovis, m./f.
cowboy	armentarius -ī, m.
crab	cammarus (marīnus) -ī, m.
crane	grūs -is, m./f.
cranium	calvāria -ae, f.
crashlanding	nāvis aëriae ruīna -ae, f.
crawfish	cancer fluviātilis -ī, m.
crew	rēmiges -um, m.
cricket-game	lūdus baculī et pilae -ī, m.
cricket	cicāda -ae, f.
crocodile	crocodīlus ī, m.
croquet	malleōrum lūsus -ūs, m.
hybrid	mixtura -ae, f.
cross-breeding	hybridisatio -ōnis, f.
cross-country	cursus silvestris -ūs, m.
cross-country-skiing	nartātōrium cursus campester -ūs, m.
cross-reference	indicium trānslātum -ī, n.
crossbreed	misceo -ae, f.
crotch	bifurcum -ī, n.
crows-nest	specula nāvis -ae, f.
crows-foot	rūgae oculī -ārum, f.
cruelty-to-animals	vexātiō bēstiarum -ōnis, f.
cruise-noun	vectūra -ae, f.
cruise-ship	nāvis orās (maris) circumvectāns -is, f.
cruiser	nāvis longa -is, f.
crustacean	crustatum animal ālis, n.
cub	catulus -ī, m.
cuckoo	coccyx -ygis, m.
ball-cue-billiards	tudicula -ae, f.
cue-sports	clāvula lūsōria -ae, f.
cufflinks	globuli gemini -orum, m.
cupola	tholus -ī, m.
cur	canis nothus -is, m.
curator	cūrātor -ōris, m.
curacao	aromaticus liquor Currassuviensis -ōris, m.
curling	Scotōrum lūsus -ūs, m.
cut-glass	vitrum caelātum -ī, n.
cutter	celōx -ōcis, f.
dachsund	(canis) taxōnīnus -is, m.
dandruff	furfur capitis -uris, m.
darwinism	Darviniī theōria -ae, f.
deck	pōns -is, m.
dedication-of-book	nuncupātio -ōnis, f.
deputy	lēgātus -ī, m.
detachment-of-retina	ablātio retīnae -ōnis, f.
diaphragm	trānsversum saeptum -ī, n.
dimple	lacūna parva (v. modica) -ae, f.
dinghy	scapha -ae, f.
dinosaur	dinosaurus -ī, m.
dirigible	aëroplanum follinum (v. Zepelinianum) -ī, n.
distillery	stillaticia officīna -ae, f.
dive-at-pool	saltus in aquam -ūs, m.
dive-high	saltus dē turrī -ūs, m.
diver	(perītus) ūrīnātor -ōris, m.
diving	ūrīnandi ars (v. disciplīna) -is, f.
diving-bell	campāna ūrīnātōria -ae, f.
diving-board	tabula dēsultōria -ae, f.
diving-gear	apparātus ūrīnātōrius -ūs, m.
diving-goggles	perspicillum ūrīnātōrium -ī, n.
dobermann	canis Dobermannius -is, m.
dock-dry	siccum nāvāle -ī, n.
dockyard	nāvālia -ae, f.
doe	cerva -ae, f.
dog-tag	lāmella canaria -ae, f.
doghouse	(canis) cubīle -is, n.
dolphin	delphīnus -ī, m.
donkey	asinus -ī, m.
door	foris -is, f.
door-revolving	cochlea -ae, f.
door-frame	replum -ī, n.
door-handle	ānsa iānuae (aperiendae) -ae, f.
door-knocker	cornīx -icis, f.
doorbell	tintinnabulum -ī, n.
double-chin	submentum -ī, n.
doubles-tennis	lūdus bis bīnōrum -ī, m.
downhill-skiing	nartatoria dēcursio simplex -ōnis, f.
draft-beer	cervesia de dōlio -ae, f.
draft	nōmen -inis, n.
dragonfly	libella -ae, f.
drawing	graphis -idis, f.
dribble	repercussus pilae -ūs, m.
driver-golf	clāva agitātōria -ae, f.
drone-bee	fūcus -ī, m.
drone	aëria nāvis sine gubernātore -is, f.
drunkenness	ēbrietās -ātis, f.
duck-billed-platypus	ornithorhynchus -ī, m.
duffel-bag	sarcina -ae, f.
eagle	aquila -ae, f.
ear-wax	aurium sordēs -is, f.
eardrum	tympanum -ī, n.
earmuffs	ligāmentum aurium -ī, n.
earthworm	lūmbricus (terrestris) -ī, m.
easel	iugum pictōrium -ī, n.
eclipse	dēfectus -ūs, m.
eclipse-solar	obscūrātio sōlis -ōnis, f.
editing	redactio -ōnis, f.
edition	ēditiō -ōnis, f.
editor	moderātor -ōris, m.
editorial-staff	cōnsilium commentāriīs moderāndīs -ī, n.
elevation-architectural-drawing	dēlīnātio sectiōnis perpendiculāris -ōnis, f.
elevator	anabathrum -ī, n.
elk	alces -is, f.
emergency-exit	exitus necessitātis (v. perīculī) -ūs, m.
emir	phylarchus Arabum -ī, m.
emirate	phylarchia -ae, f.
enamel	vitrum metallicum -ī, n.
enclyclopaedia	orbis doctrīnae -is, m.
endorsee	indorsatārius -ī, m.
endorsement	opistograhum -ī, n.
enzyme	enzymum -ī, n.
erection	ērectio pēnis -ōnis, f.
escalator	scālae mōbilēs -ārum, f.
esophagus	gula -ae, f.
estrogen	oestrogenum -ī, n.
etching	rāsio -ōnis, f.
eugenics	eugenicus -ī, m.
eustachian-tube	tuba audītīva -ae, f.
evolution	(Darviniana) animantium per gradūs mūtātiō -ōnis, f.
exhibition	expositio (v. mōnstrātio) artificiōrum -ōnis, f.
experimental	experīmentālis -e
eye-socket	orbita -ae, f.
eyeball	oculī pōmum -ī, n.
eyebrow	supercilium -ī, n.
eyelash	palpebrārum pilus -ī, m.
eyelid	palpebra -ae, f.
facial-expression	vultus -ūs, m.
facsimile	dēscrīptiō imāgōque litterārum -ōnis, f.
facsimile-edition	opus phototypice expressum -eris, n.
fakir	fakīrus -ī, m.
falcon	falco -ōnis, f.
fallen-arch	pēs plānus -edis, m.
fan	flabellum -ī, n.
fan-electric	apparātus ventilātiōnis -ūs, m.
fang	dēns (canīnus v. rapāx) -is, m.
farm	fundus rūs ī, m.
farmer	agricola -ae, m.
farmhand	operarius agrārius (v. rusticus) -ī, m.
farmhouse	vīlla -ae, f.
farming	agrī cultūra -ae, f.
farmyard	cohors -ortis, f.
fawn-deer	hinnuleus -ī, m.
facade	frōns -tis, f.
felthat	petasus coāctilis -ī, m.
fencer	gladiātor -ōris, m.
fencing-foil	dolō bullātus -ī, m.
fencing-master	lanista -ae, m.
fencing-match	certāmen rudium (v. gladiātōrium) -inis, n.
fencing-school	lūdus gladiātōrius -ī, m.
fermentation	fermentātio (vīnōsa v. alcoholica) -ōnis, f.
ferret	viverra -ae, f.
ferry-boat	nāvis traiectōria -is, f.
ferryman	portitor -ōris, m.
fertilizer	stercus -oris, n.
fertilizer-chemical	fimus (chemicus) -ī, m.
fiber	fibra -ae, f.
field-hockey	alsulegia prātensis -ae, f.
field-hockey-ball	pila alsulegia -ae, f.
field-hockey-player	alsuelgiārius -ī, m.
figure-skater	patinator artifex -ōris, m.
figure-skating	patinatio artificiōsa -ōnis, f.
filigree	diātrēta -ae, f.
financial-instutution	īnstitūtm monetale -ī, n.
fine-arts	artēs liberālēs -um, f.
fingernail	unguis -is, m.
fingernail-clipping	resegmina unguium -um, n.
fingertip	digitus extrēmus -ī, m.
firefly	cicindēla -ae, f.
first-half	tempus prīmum -oris, n.
fish-hatchery	ichthyotrophium -ī, n.
fishbone	spīna piscis -ae, f.
flagship	nāvis praetōria -is, f.
flick	crepitus -ūs, m.
flight-airtravel	volātus -ūs, m.
flight	volātus -ūs, m.
flight-attendant	hospes aëronauticus -itis, m.
flight-path	cursus volāticus (v. volatūrae) -ūs, m.
float	cortex -icis, m.
floor	pavīmentum -ī, n.
floor-level	tabulātum -ī, n.
floor-plan	operis dēscrīptiō -ōnis, f.
ground-floor	tabulātum inerius -ī, n.
flute	stria -ae, f.
fluting	striātūra -ae, f.
fly	musca -ae, f.
folded-hands	manūs iunctae -uum, f.
food-chain	catēna alimentaria -ae, f.
football	follis -is, m.
football-player	pedisphaerista -ae, m.
footnote	adnotātio (īmae pāginae) -ōnis, f.
footwear	calceāmentum -ī, n.
forearm	bracchium -ī, n.
forecastle	prior pars nāvis -is, f.
forefinger	index -icis, m./f.
foreground	pars antica -is, f.
foreleg	crūs prius -ūris, n.
forward-player	oppugnātor -ōris, m.
frame	antepagmentum -ī, n.
frame-painting-noun	rēgula (quadrāta) -ae, f.
frame-picture	fōrma -ae, f.
freckle	ephēlis -idis, f.
freedom-of-the-press	rēī librāriae libertās -ātis, f.
fresco	opus tēctōrium -eris, n.
frieze	zōophorus -ī, m.
frog	rāna -ae, f.
frogman	ūrīnātor spīrāculō rnunitus -ōris, m.
froth-head-of-beer	flōs (v. spuma) cervesiae -ōris, m.
fungicide	(venēnum) fungicidale -is, n.
gable	fastīgium -ī, n.
gadfly	tabanus -ī, m.
galaxy	coetus ingēns stēllārum -ūs, m.
gall	bīlis -is, f.
gall-bladder	fel -is, n.
gallery	porticus -ūs, f.
gallery-art	pinacothēca -ae, f.
gallery-balcony	tribūnal -ālis, n.
galley	nāvis actuāria -is, f.
galley-slave	rēmex servus -igis, m.
gallop	cursus citātus -ūs, m.
galoshes	calceorum indumentum -ī, n.
gamete	cellula sexuālis -ae, f.
gangplank	pōns is, m.
gas-heating	calefactio gasalis -ōnis, f.
gas-main	ductus gasalis -ūs, m.
gas-meter	gasometrum -ī, n.
gastric-juice	sūcus gastricus -ī, m.
gene	gen indeclinable
genetics	genetica (doctrīna) -ae, f.
genitals	genitālia -ōrum, n.
genus	nōmen genericum -inis, n.
gesture	gestus -ūs, m.
gills	branchiae -arum, f.
gin	vīnum iūniperum -ī, n.
giraffe	camēlopardus ī, m.
girder	trabs -is, f.
gizzard	ventriculus avis anterior -ī, m.
gland	glandule -is, n.
glassblower	vitreārius -ī, m.
glider-for-hang-gliding	aëronavis vēlifera (v. vēlifica) -ae, f.
glider-person	deltaplānista -ae, f.
glider-hang	deltaplānum -ī, n.
glider-sailplane	(aëroplanum) vēlivolum -ī, n.
glove	chirothēca digitata -ae, f.
glowworm	cicindēla -ae, f.
glycogen	glycogenium -ī, n.
gnat	culex -icis, m.
goal-football	porta -ae, f.
goal-line	linea portāria -ae, f.
goal-post	pālus -ī, m.
goal-keeper	custōs -ōdis, m./f.
goalie-soccer	iānitor -ōris, m.
goldfinch	acalanthis -idis, f.
goldfish	hippurus -ī, m.
golf	pilamalleus -ī, m.
golf-caddie	bāiulus malleōrum -ī, m.
golf-cart	carrulus malleōrum -ī, m.
golf-club	clāva -ae, f.
golf-course-hole	scrobiculus -ī, m.
golf-green	ārea viridis -ae, f.
gonads	glandulae genitāles -ārum, f.
gondola	cymbula -ae, f.
grain	horreum -ī, n.
grasshopper	gryllus -ī, m.
grating	forīculae -ārum, f.
great-tit	misinga -ae, f.
grenade-shell	granata -ae, f.
greyhound	vertagus -ī, m.
grisaille	leucophaeus -um, n.
grizzly-bear	ursus -ī, m.
groin	inguen -inis, n.
groove	stria -ae, f.
grouse	tētrao -ōnis, m.
grub	vermiculus -ī, m.
guinea-pig	mūs porcellus -ūris, m.
gull-bird	larus -ī, m.
gum-of-mouth	gingīva -ae, f.
gunboat	lembus -ī, m.
gymnastics	ars gymn(ast)ica -is, f.
gymnist	gymnasticus -ī, m.
habitat	biochōr -ōris, m.
haddock	gadus -ī, m.
half-moon	lūna dīmidi(at)a -ae, f.
halibut	hippoglossus -ī, m.
hall-building	basilica -ae, f.
halo	corōna -ae, f.
ham	poples -itis, m.
hamster	cricētus -ī, m.
hamstring	poplitis nervus -ī, m.
handball	manufollium -ī, n.
handball-ball	manufollis -is, m.
handball-game	manufollium -ī, n.
handball-player	lūsor manufollis -ōris, m.
handbook	libellus -ī, m.
handkerchief	sūdārium -i, n.
handrail	epimedion -ī, n.
hang-gliding	vēlificātio aērea -ōnis, f.
hangar	tugurium (v. tegurium) aëroplani -ī, n.
hangover	gravēdō crāpulae -ēdinis, f.
harelip	labium leporīnum -ī, n.
harem	gynaecēum (regium) -ī, n.
hat	galēriculum -ī, n.
hatberet	pīleus Vasconicus -ī, m.
hatbonnet	mitra -ae, f.
hatcap	pilleus -ī, m.
hatfelthat	petasus coāctilis -ī, m.
hatstrawhat	pīleus strāmineus -ī, m.
hattophat	petasus altus -ī, m.
hatturban	tiāra -ae, f.
haunch	clūnis -is, m./f.
haut-relief	ectypon -ī, n.
hawk	accipiter -itris, m.
heat-central	calefactio centrālis -ōnis, f.
heating-radiator	focus -ī, m.
hedgehog	erināceus porcīnus -ī, m.
heelofshoe	fulmenta -ae, f.
helicopter	helicopterum -ī, n.
helm	gubernāculum -ī, n.
helmsman	gubernātor -ōris, m.
hemoglobin	haemoglobīnum -ī, n.
hermaphrodite	hermaphrodītus -ī, m.
heron	ardea -ae, f.
herring	harenga -ae, f.
hibernation	somnus brūmalis -ī, m.
hiccup	singultus -ūs, m.
highheels	calces altiusculae -ium, f.
highball	aqua vītae -ae, f.
hijacking	aëroplāni (v. aëria) abductio -ōnis, f.
hike	ambulātio -ōnis, f.
hiker	oribates -ae, m.
hiking	ambulātiōnes -um, f.
hiking-boot	calceāmentum clāvātum -ī, n.
hikingshoe	calceus carpatinus (v. clāvatus) ī, m.
hip	coxa -ae, f.
hippopotamus	hippopotamus -ī, m.
hockey	pilamalleus -ī, m.
hockey-puck	discus -ī, m.
hockey-stick	malleus repandus -ī, m.
home-baseball	summa statiō -ōnis, f.
hookah	māchina fūmifera -ae, f.
hoop	trochus -ī, m.
hoopoe	upupa -ae, f.
hops	lupus -ī, m.
hormone	hormōnum -ī, n.
hornet	crābrō -ōnis, m.
hothouse	plantārium -ī, n.
houseboat	thalamēgus -ī, f.
hovercraft	scapha (automaria) Hōveriana -ae, f.
hull	alveus -ī, m.
hound	canis vēnāticus (v. vēnātor) -is, m.
hurdle	claustra -ōrum, n.
huskie	canis traharius -is, m.
hydrofoil	āliscapha -ae, f.
hydroplane	hydroplānum -ī, n.
hyena	hyaena -ae, f.
hymen	hymen -inis, m.
ice-hockey	alsulegia glaciālis -ae, f.
ice-hockey-player	alsulegiārius lūsiōnis glaciālis -ī, m.
ice-skates	soleae glaciē gestandi -ārum, f.
ice-skating	patinatio -ōnis, f.
illustration	tabula -ae, f.
illustrator	tabulārum pictor -ōris, m.
impressionism	impressiōnismus -ī, m.
impressionist	impressiōnista -ae, m.
incendiary-bomb	bomba incendiāria -ae, f.
incubation	incubātio -ōnis, f.
incubator	īnstrūmentum incubātiōnis -ī, n.
index-finger	(digitus) index -ī, m.
index-of-prohibited-books	index librōrum prohibitōrum -icis, m./f.
indoor-tennis	tenilūdium aulāre -ī, n.
inning	pilae vices -um, f.
insect	insectum -ī, n.
insecticide	(venēnum) insectidiale -is, n.
instep-foot	pars pedis superior -is, f.
instep	mōns pedis -is, m.
insulator	māteria impervia -ae, f.
intestinal-worm	vermis intestīnalis -is, m.
intestine	intestīnum -ī, n.
intestines	intestīnum -ī, n.
introduction	prooemium -ī, n.
invertebrate	invertebratus -ī, m.
iris	iris -idis, f.
islam	Islamismus -ī, m.
jackal	thōs (v. thōis) -ōis, m.
jackass	asinus -ī, m.
jai-alai-pelota	(pilae) lūsus vasconicus -ūs, m.
janissary	mīles iānitārius -itis, m.
janitor	ātriēnsis -is, m.
jellyfish	urtīca marīna -ae, f.
jet	aëronāvis retrōversus impulsus -is, f.
jet-stream	scatebra -ae, f.
jewel	ōrnāmentum -ī, n.
jeweler	gemmarius -ī, m.
jewelry	ōrnātus -us, m.
jewelrybrooch	fībula -ae, f.
jewlerycarat	ceratium -ī, n.
earrings	inaures -ium, f.
jewelryearrings	inaures -ium, f.
jewelrylocket	theca -ae, f.
jewelrynecklace	mūrenula -ae, f.
jewelrypearl	margarīta -ae, f.
jewelrypendant	ōrnāmentum pēnsile -ī, n.
jewelrypin	acus ōrnātiva -ūs, f.
jogging	cursus pedester -ūs, m.
joint	iunctio -ōnis, f.
joist	tignum trānsversārium (v. trānsversum) -ī, n.
judo	lucta Iūdōica -ae, f.
junk	nāvis Sinica -is, f.
kaaba	templum Meccanum -ī, n.
kangaroo	halmatūrus -ī, m.
karate	lucta carātica -ae, f.
kennel	cubīle -īlis, n.
kingfisher	alcēdō -inis, f.
kite	dracō volāns -ōnis, m.
kite-bird	milvus -ī, m.
kitten	catulus felinus -ī, m.
knee	genū -ūs, n.
kneecap	patella -ae, f.
knock-knees	crūra vāra -ōrum, n.
koran	Corānus -ī, m.
laboratory-animal	bēstiola experīmentalis -ae, f.
ladybug	coccinella -ae, f.
lamb	agnus -ī, m.
landing	appulsus -ūs, m.
landing-craft	scaphae longārum nāvium militibus complēndae -ārun, f.
landscape	prōspectus -ūs, m.
landscape-a-painting-of-landscape	topia -ōrum, n.
landscape-painter	pictor topiārius -ōris, m.
landscape-painting	topiōrum pictūra -ae, f.
lap	gremium -ī, n.
lapdog	catellus -ī, m.
large-octavo	(liber) fōrmae octāvae māioris -ī, m.
lark	alauda -ae, f.
larynx	guttur -uris, n.
latin	LATIN_TRANSLATION_HERE GRAMMAR_HERE
lattice	transenna -ae, f.
lawn-tennis	taenilūdium prātense -ī, n.
leaflet	folium plicātile -ī, n.
leash	cōpula -orum, n.
ledge	proectūra -ae, f.
leech	sanguisūga -ae, f.
leopard	(leo)pardus -ī, m.
life-buoy	orbis auxiliārius -is, m.
life-jacket	thōrāx natātōrius -ācis, m.
life-preserver	cortices -um, m.
lifeboat-liferaft	nāvicula ad servāndum -ae, f.
lifeguard	praetōrium nantium -ī, n.
lifeguard-pool-attendant	balneārius -ī, m.
ligament	ligāmen -inis, n.
lightning-conductor	apagōgus fulminis -ī, m.
liqueur	liquor aromaticus -ōris, m.
liquor	fortioris (v. fervidioris) spīritūs liquor -ōris, m.
lithograph	tabula lithographica -ae, f.
lithographer	artifex lithographus -icis, m.
lithography	lithogrica ars -is, f.
little-dipper	Ursa Minor -ae, f.
little-finger	(digitus) auriculāris -ī, m.
liver	iecur -oris, n.
lizard	lacerta -ae, f.
lobby	vestibulum (theātrī) -ī, n.
lobe	lacinia -ae, f.
lobster	locusta (marīna) -ae, f.
lock-sluice	saeptum -ī, n.
locket	theca -ae, f.
loft	tabulātum -ī, n.
look-out-tower	turris speculātōria -is, f.
louse	pediculus -ī, m.
lower-jaw	maxilla īnferior -ae, f.
lunar-eclipse	lūnae dēfectus -ūs, m.
lung	pulmō -ōnis, m.
lymph	lympha -ae, f.
lymph-node	lymphonōdus -ī, m.
lymphatic-vessel	vās lymphāticus -āsis, n.
lynx	lynx -yncis, f.
mackerel	scomber -ī, m.
maggot	vermiculus -ī, m.
malt	horteum -ī, n.
mammal	mammālis -arum, n.
man-of-war	nāvis longa -is, f.
manger	praesaepe -is, n.
manual	libellus -ī, m.
manureheap	sterculīn(i)um -ī, n.
manuscript	scrīptum -ī, n.
marathon	cursus Marathonius -ūs, m.
marginal-note	verba marginī adscrīpta -ōrum, n.
marina	statiō (v. portus) lūsoriārum -ōnis, f.
marine-biologist	biologus maritimus -ī, m.
marine-biology	thalassobiologia -ae, f.
marl	marga -ae, f.
marmot	mūs Alpīnus -ris, m.
marrow	medulla -ae, f.
marten	mēles (martes) -is, f.
mass-media	īnstrūmenta commūnicātiōnis sociālis -ōrum, n.
masterpiece	summum opus -eris, n.
medallion	īnsigne magnum -is, n.
meiosis	meiōsis -is, f.
membrane	membrāna -ae, f.
merchant-marine	nāves onerāriae -um, f.
metabolism	metabolismus -ī, m.
meteor	meteoron -ī, n.
meteorite	stēllārum ignītum fragmentum -ī, n.
microbiological	microbiologicus -ī, m.
microbiologist	microbiologus -ī, m.
microbiology	microbiologia -ae, f.
microfiche	microchartula -ae, f.
microfilm	micropellicula -ae, f.
middle-finger	digitus medius -ī, m.
midget-pygmy	nānus -ī, m.
migration	migrātiō avium -ōnis, f.
migratory-bird	volucris peregrīna -is, f.
milking-machine	lactisūgium automatum -ī, n.
milky-way	orbis (v. circulus) lacteus -is, m.
millipede	millepeda -ae, f.
minaret	minarētum -ī, n.
miniature	parvus -ae, f.
miniature-golf	pilamelleus minūtus -ī, m.
minister-of-agriculture	administer agriculturae prōvehendae -ī, m.
ministerofcommerce	mercuratis moderandis provehendisque administer ī, m.
ministerofculturalaffairs	(ad)minister cultūs et ēducātīonis -ī, m.
ministeroffinance	(ad)minister fiscalis -ī, m.
ministeroftheinterior	(ad)minister pūblicus rerum interiorum -ī, m.
secretary	(ad)minister pūblicus -ī, m.
ministryoftheinterior	ministerium administrātiōnis internae -ī, n.
ministry	suprēmum cōnsilium -ī, n.
miscellany	strōmata -ōrum, n.
misprint	errātum impresssum -ī, n.
mite	acarus -ī, m.
mixed-doubles	lūdus mixtus bis bīnōrum -ī, m.
moccasin	calceus laxus -ī, m.
moccasin-snake	natrix -icis, f.
artists-model	sessor pictōris -ōris, m.
molecular-biology	biologia moleculāris -ae, f.
molecule	moleculua -ae, f.
mollusk	testa -ae, f.
money-belt	zōna (pecūniāria) -ae, f.
mongrel	hybrida -ae, f.
monograph	scrīptum dē ūno capite -ī, n.
moonlight	lūmen lūnae -inis, n.
moons-of-jupiter	planētae circumioviales -ārum, m.
moonshine	tēmētum illicitum -ī, n.
mosaic	opus musīvum (v. tessellātum v. musaicum) -eris, n.
mosque	meschīta -ae, f.
mosquito	culex -icis, m.
moth	tinea -ae, f.
motorboat	automatārium nāvigium -ī, n.
mountain-climbing-rope	fūnis ascensōrius -is, m.
mucous-membrane	membrāna pituitāria -ae, f.
muezzin	muazinus -ī, m.
muff	chirothēca bipatēns -ae, f.
mufti	mufti indeclinable
mural-painting	pictūra parietalis ae, f.
muscatel	vīnum apiānum -ī, n.
muscle	nervus -ī, m.
museum	mūsēum -ī, n.
muslim-subst	Mahometanus -ī, m.
mussel	conchylium -ī, n.
mustang	equiferus -ī, m.
muzzle	rōstrum -ī, n.
nadir	pūnctum īmum -ī, n.
nasal-septum	imbrex nārium -icis, f.
navigation	disciplīna nāvālis -ae, f.
necklace	mūrenula -ae, f.
nervous-system	nervi -ōrum, m.
niche	aedicula -ae, f.
nightingale	luscinia -ae, f.
nominee	candidātus -ī, m.
north-star	sepentrio -ōnis, m.
nozzle	forāmen -inis, n.
nucleus-of-cell	nūcleus cellulāris -ī, m.
observatory	specula astronomica -ae, f.
officialsubst	officialis administrativus (v. administrationis) -is, m.
oil-paint	pigmentum oleō mixtum -ī, n.
oil-painting	pictūra oleāria -ae, f.
oil-tanker	nāvis oleāria -is, f.
optic-nerve	nervus opticus -ī, m.
orangutan	pongo -onis, m.
orbit	orbita -ae, f.
organ	membrum -ī, n.
oriole	chlorion -ōnis, m.
ornithology	ornithologia -ae, f.
ostrich	struth(i)ocamelus -ī, m.
outer-space	spatium cosmicum -ī, n.
outline-sketch	sciagraphia -ae, f.
ovary	ovārium -ī, n.
pack-of-dogs	turba canum -ae, f.
packet-boat	nāvis tabellāria -is, f.
paddle	rēmus bipalis -ī, m.
paddleboat	linter bipalis -is, f.
page-proof	plagula -ae, f.
pagination	pāginārum numerātio -ōnis, f.
paintbrush	penicillus -ī, m.
painting	tabula (v. tabella) picta -ae, f.
palette	orbis pictōrius -is, m.
palfrey	asturco -ōnis, m.
palm	palmus -ī, m.
pancreas	pancreas -atis, n.
panel	tympanum -ī, n.
paneling	contabulātio -ōnis, f.
papier-mache	mācerāta charta -ae, f.
papyrus-book	cōdex papyraceus -icis, m.
parachute	umbella dēscēnsoria -ae, f.
parapet	crepīdō -īdinis, f.
parchment-book	cōdex membrānaceus -icis, m.
parrot	psittacus -ī, m.
parthenogenesis	parthenogensis -is, f.
partition	pariēs intergerius (v. medius) -ētis, m.
partridge	perdix -īcis, m./f.
pass-football	pilae transmissio -ōnis, f.
passenger-ship	nāvis epibatica -is, f.
pastel	xerochrōma -atis, n.
pavillion	pāpiliō -ōnis, m.
peacock	pāvō -ōnis, m.
pearl	margarīta -ae, f.
pedal-boat	scapha pedalicia -ae, f.
pelican	onocrotalus -ī, m.
pelvis	pelvis -is, f.
penalty-kick	iactus poenālis -ūs, m.
pendant	ōrnāmentum pēnsile -ī, n.
penguin	aptenodtyes -um, m.
penis	pēnis -is, m.
penthouse	appendicium -ī, n.
pepsin	pepsīnum -ī, n.
periscope	periscopium -ī, n.
perspective	perspectīva -ae, f.
pest	animal nocivum -ālis, n.
pesticide	(venēnum) pesticidale -is, n.
pet	animal domesticum (v. pecusculum familiāre) -ālis, n.
pharynx	faucēs -ium, f.
phase-of-the-moon	phāsis lūnae -idis, m.
pheasant	phasianus -ī, m.
photographic-reprint	ēditiō phototypica (v. photomechanica) -ōnis, f.
physique-build	corporis figūra -ae, f.
picture-book	liber imāginibus ōrnātus -ī, m.
pigeon-carrier	columba internūntia -ae, f.
piggy-bank	thēca nummāria -ae, f.
pigmentation	color -ōris, m.
pilot	rēctor -ōris, m.
pilsner	cervesia Pilonica -ae, f.
pimple	fūrunculus -ī, m.
pin	acus ōrnātiva -ūs, f.
ping-pong	lūdus pilae mēnsālis -ī, m.
pirated-edition-reprinting	recūsio fūrtīve -ōnis, f.
pitcher-thrower	missor -ōris, m.
planet	stēlla errāns (v. vaga) -ae, f.
plastering-roughcast	dīrectio -ōnis, f.
plastic-bag	sacculus (plasticus) -ī, m.
platform	rōstrum -ī, n.
playing-field	campus (lūsōrius v. gymnasticus) -ī, m.
polecat	fēles -is, f.
pollen	pollen -inis, n.
pollination	pollinātio -ōnis, f.
polo	alsulegia equestris -ae, f.
pontoon	hydroplāni cymbula -ae, f.
poodle	canis villōsus -is, m.
porcupine	ēricius -ī, m.
pore	(cutis) fistula -ae, f.
porpoise	tursio -ōnis, m.
port	vīnum Portucalense -ī, n.
portfolio	scrīnium -ī, n.
porthole	fenestra nāvis -ae, f.
portrait-painter	anthropographus -ī, m.
pound	saeptum -ī, n.
prefabricated	praestrūctus -ī, m.
premier	prīnceps -ipis, m.
presidency	praesidatus -ūs, m.
president	praeses -idis, m.
president-elect	praeses designātus -idis, m.
press-media	rēs pressōria -ēī, f.
primeminister	minister primarius -ī, m.
print	litterae impressae -ārum, f.
printer	typographus -ī, m.
printing	typographia -ae, f.
press-print	apparātus ad imprimendum -ūs, m.
printshop	officīna typographica -ae, f.
prizefight	pugilātus -ūs, m.
prizefighter	pugil mercēnārius -ilis, m.
proofreader	corrēctor scriptōrum -ōris, m.
proofreading	corrēctiō scriptōrum -ōnis, f.
propeller	helica -ae, f.
prostate-gland	prostata -ae, f.
protozoan	protozōon -ontis, n.
pubic-hair	pecten -inis, m.
publisher	domus (v. societās) ēditōria -ūs, f.
pug	(canis) fricātor -oris, m.
pullet	pullastra -ae, f.
pump	soccus -ī, m.
punt	ictus follis ex pede -ūs, m.
pupil	pūpula -ae, f.
purse	pērula manuāria -ae, f.
pylon	porta crassa -ae, f.
python	serpēns immānis -entis, f.
quadruped	quadrupēs -edis, m./f.
quail	coturnix -īcis, f.
quarterdeck	puppis superior -is, f.
quoit	discus -ī, m.
quotation	prōlātiō -ōnis, f.
rabbit-hutch	claperium cunīculorum -ī, n.
race-contest	cursus -ūs, m.
race-track	curriculum -ī, n.
racehorse	celēs -etis, m.
radiator	radiator -ōris, m.
radiocarbon-dating	computātio (aetātis) radiocarbonica -ōnis, f.
radiotelescope	radiotelescopium -ī, n.
raft	ratis -is, f.
rafter	trabs -is, f.
ranch	fundus pecuārius -ī, m.
rancher	pecuārius -ī, m.
rat	rattus -ī, m.
rattrap	mūscipula -ae, f.
rattlensake	serpēns crotalus horridus -entis, f.
raven	corvus -ī, m.
reaper	māchina messoria -ae, f.
recess-niche	recessus -ūs, m.
record	prīmātus -ūs, m.
reference	relātio -ōnis, f.
reference-books	librī citātī -ōrum, m.
regatta	certāmen cursūs vēlificī -inis, n.
reindeer	tarandrus -ī, m.
relay-race	cursus pūblicī -ūs, m.
reprint-noun	opus recusum -eris, n.
reproduction	prōcreātio -ōnis, f.
reproductive-organs	organa generātiōnī īnserviēntia -ōrum, n.
reptile	repēns animal -ālis, n.
respiratory-tract	spīrāndi meātus -ūs, m.
retina	(tunica) retīna -ae, f.
review	cēnsūra -ae, f.
rhinoceros	rhinoceros -otis, m.
ribbon	īnstita -ae, f.
ring-finger	digitus ānulāris -ī, m.
ripcord	restis tractilis -is, f.
robin	rubecula -ae, f.
rock-climber	rūpium ascencor -ōris, m.
rocket	missile -is, n.
rodent	rōdēns -entis, m./f.
roller-skater	patinātor rotālīs -ōris, m.
roller-skating	patinātio rotālīs -ōnis, f.
rook	cornix -īcis, f.
rotunda	tholus -ī, m.
roundworm	ascaris -idis, f.
rowboat	nāvicula scalmōrum -ae, f.
rower	rēmex -igis, m.
rowing	athletismus rēmigatōrius -ī, m.
rubber-dinghy-life-raft	cummea scapha -ae, f.
rudder	gubernāculum -ī, n.
rugby	follis ovātī lūdus -ī, m.
rum	rhōmium -ī, n.
runway	(avi) aditus aërodromī -ūs, m.
sable	mūs silvestris -ris, m.
safe	arca nummāria (lōrīcata) -ae, f.
sail-noun	vēlum -ī, n.
sailboat	scapha (v. cumba) vēlifera -ae, f.
sailing	nāvigātio -ōnis, f.
sailing-ship	nāvis vēlivola -is, f.
saint-bernard	canis Bernardinus (v. Poenius) -is, m.
salamander	salamandra -ae, f.
sandal	crepida -ae, f.
sangria	pōtiō mixta Hispanica -ōnis, f.
sash	cancelli -ōrum, m.
satellite	stēlla minor -ae, f.
savings-account	pecūnia comparsa -ae, f.
savings-bank	prōvehendae parsimōniae argentāria -ae, f.
scalp	cutis capitis -is, f.
scarecrow	homō faeneus -inis, m.
scarfmuffler	amictorium -i, n.
schnapps	aqua vītae (v. ardēns) -ae, f.
schnapps-kirschwasser	aqua cerasina -ae, f.
schooner	āctuārium nāvigium -ī, n.
scotch	vischium Scoticum -ī, n.
scuba	scaphandra automata -ae, f.
sculptor	sculptor -ōris, m.
sculpture-statue	opus (in)sculptum -eris, n.
sea-gull	larus -ī, m.
hippocampus	hippocampus -ī, m.
sea-horse	hippocampus -ī, m.
sea-plane	hydroplānum -ī, n.
seal	vitula marīna -ae, f.
seasickness	nausea -ae, f.
second-half	tempus secundum (v. alterum) -oris, n.
secretary-general	scrība primarius -ae, m.
serpent	anguis -is, m./f.
serum	serum -ī, n.
serve-in-tennis	dēiectus -ūs, m.
server-in-ball-game	missor -ōris, m.
setter-dog	canis vēnāticus (v. canis consistēns) -is, m.
shaft	scapus (truncus) -ī, m.
shank	crūs -ūris, n.
sharecropper	colōnus -ī, m.
shark	pristis -is, f.
shawl	anaboladium -ī, n.
shelter	subgrunda -ae, f.
shelter-refuge	(alpicum) dēversōriolum -ī, n.
sheepdog	canis pāstōrālis (v. pecuārius) -is, m.
sherry	vīnum Astense Hispanicum -ī, n.
shin	tībia -ae, f.
shinbone	tībia -ae, f.
shingle	tēgula -ae, f.
ship-owner	dominus nāvis -ī, m.
ships-mate	operārius nauticus -ī, m.
ship-building	architectūra nāvālis -ae, f.
shipwreck	nāvis fracta -is, f.
shipyard	nāvālia -ae, f.
shoe	calceus -ī, m.
shoepolish	unguen calceorum -inis, n.
shoemaker	sūtor cerdo -oris, n.
shoerepairer	sūtor cerdo -ōris, m.
bootblack	calceorum polītor (v. mundator v. expurgātor) -ōris, m.
shoehorn	inductōrium -ī, n.
shoelace	corrīgia calceāmentī -ae, f.
shoestore	(taberna) sūtrīna -ae, f.
shooting-star	acontiae -ārum, m.
shoulder	umerus -ī, m.
shuttlecock	pennāta pila -ae, f.
sideline	linea laterālis -ae, f.
silo	sīrus -ī, m.
singles-tennis	lūdus singulāris -ī, m.
skate-ice	ferrāta solea -ae, f.
roller-skate	pedirota -ae, f.
rink	harēna lūbrica (v. gelida) -ae, f.
skeleton	ossa -ōrum, n.
sketch-noun	lineāmenta -ōrum, n.
ski-noun	narta -ae, f.
ski-jacket	iacca nartātōria -ae, f.
ski-jump	suggestus dēsultōrius -ūs, m.
ski-lift	anabathrum nartātōrium -ī, n.
ski-lodge	casa nartātōrum -ae, f.
ski-slope	curriculum (v. iter) narticum -ī, n.
skier	nartātor -ōris, m.
skiff	scapha -ae, f.
skiing	nartātiō -ōnis, f.
skiing-equipment	(ap)parātus nartātōrius -ūs, m.
skull	cranium -ī, n.
skunk	mephītis -is, f.
skyscraper	domus multōrum tabulātōrum -ūs, f.
slalom	dēcursio flexuōsa -ōnis, f.
slipper	ūdo -ōnis, m.
sloop	lembus -ī, m.
sloth	bradypus -podis, f.
slug	līmax -ācis, f.
sluice	obiectāculum -ī, n.
small-book-pocket-book	libellus -ī, m.
snail	cochlea -ae, f.
escargot	helix pōmātia -icis, f.
snake-bite	morsus vīperae -ūs, m.
sneaker	calceus gymnicus -ī, m.
snorkel	tuba spīrāndi -ae, f.
soccer	pedilūdium -ī, n.
soccer-ball	pedifollis -is, m.
soccer-field	campus pedifoliī -ī, m.
soccer-game	pedifollium -ī, n.
soccer-player	lūsor pedifollis -ōris, m.
society-for-prevention-of-animal-cruelty	societās animālibus tutandis -ātis, f.
soft-palate	vēlum -ī, n.
solar-plexus	plexus sōlāris -ūs, m.
solar-system	ōrdō sōlaris -inis, m.
sole	planta -ae, f.
somersault	saltus cernui -ūs, m.
space-age	aetās cosmica ātis, f.
space-shuttle	spatiāle vehiculum reciprocum -ī, n.
spaniel	canis avicularius -is, m.
sparkling-wine	vīnum spūmāns -ī, n.
sparrow	passer -eris, m.
sparrow-hawk	falco nīsus -ōnis, m.
speedboat	nāvis vēlox -is, f.
sperm-cell	spermatozoīdum -ī, n.
spermaceti	cetaceum -ī, n.
spider	arānea -ae, f.
spinal-column	spīna dorsī -ae, f.
spleen	liēn -ēnis, m.
sponge	spongi(ol)a -ae, f.
springboard	petaurum -ī, n.
sprint	breve curriculum -ī, n.
squirrel	sciurus -ī, m.
stag	cervus -ī, m.
stained	vitrum tīnctum -ī, n.
stained-glass	abaculus -ī, m.
art-of-making-stained-glass	pictūra encaustica -ae, f.
stained-glass-artist	vitripictor -ōris, m.
stair	gradus -ūs, m.
staircase	scālae -ārum, f.
stall	stabulum -ī, n.
stamen	caulis sēmina ferēns -is, m.
stampede	ēruptiō (orfuga) animālium -ōnis, f.
starboard	dextrum (nāvigiī) latus -eris, n.
starling	sturnus -ī, m.
steamboat	pyroscapha -ae, f.
steel-engraving	chalybographia -ae, f.
steerage	vīscera nāvis -um, n.
still	fornācula (v. clibanus) stillaticia -ae, f.
stilts	grallae -ārum, f.
stingray	pastinaca -ae, f.
stomach	stomachus -ī, m.
stool	faex -is, f.
stork	cicōnia -ae, f.
stove	fornāx -ācis, f.
stowaway	vector clandestīnus -ōris, m.
strand-beach	litus -oris, n.
straw	strāmentum -ī, n.
strawhat	pīleus strāmineus -ī, m.
stucco	tēctōrium -ī, n.
sturgeon	acipēnser -eris, m.
style	strūctūrae (artisque) genus -eris, n.
submarine	nāvis subaquānea -is, f.
suitcase	riscus -ī, m.
sultan	sultānus -ī, m.
sunbath	aprīcātiō -ōnis, f.
sunburn-verb	erythēma sōlare -ae, f.
sunscreen	cerōma solare -ae, f.
sunspot	macula sōlis -ae, f.
suntan-oil	oleum sōlare -ī, n.
supersonic-speed	vēlōcitās supersonica -ātis, f.
sura	sura -ae, f.
surfboard-for-wind-surfing	tabula vēlifera -ae, f.
surfing	prōlapsio super undas -ōnis, f.
swallow	hirundō -inis, f.
swim-meet	certāmen natātōrium -inis, n.
swimming	natātio -ōnis, f.
swimming-pool	balneum pūblicum (subdiāle) -ī, n.
swordfish	helops gladius (v. xiphus) -opis, m.
synopsis	sūcus -ī, m.
table-of-contents	index (rērum v. contentōrum) -icis, m./f.
table-wine	vīnum cibarium -ī, n.
tack	antenna -ae, f.
tadpole	gyrīnus -ī, m.
taikwondo	lucta Coreana (v. Thequondoīca) -ae, f.
tamer	domitor ferarum -ōris, m.
tanned-skin	adustus color -ōris, n.
tapestry	tapēte -is, n.
tapeworm	taenia -ae, f.
tarantula	tarantula -ae, f.
target-shooting	iaculātio ad mētam -ōnis, f.
team-captain	ductor manipulī (lūdicrī) -ōris, m.
teetotaler	homō abstinēns (tēmētō) -inis, m.
teller-cashier	arcārius -ī, m.
tendon	nervus -ī, m.
tennis	manūbriātī rēticulī lūdus -ī, m.
tennis-ball	pila tenisiae -ae, f.
tennis-court	teniludiī campus -ī, m.
tennis-player	tenilūdius -ī, m.
tennis-racket	rēticulātus -ī, m.
tennis-tournament	certāmen tenisiae -inis, n.
tent	tentōrium -ī, n.
tentacle	cornū -ūs, n.
terrier	terrarius -ī, m.
theory-of-evolution	theōria evolutiōnis -ae, f.
thoroughbred	genuīnus -ī, m.
thyroid-gland	glandula thyreoīdea -ae, f.
tick	ricinus -ī, m.
tie	fōcāle -is, n.
tiepin	spīnula -ae, f.
tiger	tigris -is, m./f.
tile	tēgula -ae, f.
time-deposit	pecūnia in tempus data -ae, f.
time-out	dīlūdium -ī, n.
tip-of-the-tongue	prīma lingua -ae, f.
animal-template	LATIN_TRANSLATION_HERE GRAMMAR_HERE
arch-template	LATIN_TRANSLATION_HERE GRAMMAR_HERE
art-template	LATIN_TRANSLATION_HERE GRAMMAR_HERE
bag-template	LATIN_TRANSLATION_HERE GRAMMAR_HERE
ball-template	LATIN_TRANSLATION_HERE GRAMMAR_HERE
biology-template	LATIN_TRANSLATION_HERE GRAMMAR_HERE
title	titulus -ī, m.
title-page	index (librī) -icis, m./f.
titmouse	misinga -ae, f.
toad	būfō -ōnis, m.
toast	tosta -ae, f.
toastmaster	magister bibendi -ī, m.
tobogganing	sclodiae (v. stludionis) dēcursus -ūs, m.
toe	digitus -ī, m.
tome	magnus liber -ī, m.
tonnage	amphorātum -ī, n.
tonsils	tonsillae -ārum, f.
tophat	petasus altus -ī, m.
topsail	siparum -ī, m.
tortoise	testūdō terrestris -inis, f.
tour-de-france	Circuitio Birotālis Gallica -ōnis, f.
towpath	sēmita nautārum -ae, f.
trainer-coach	exercitor -ōris, m.
trampoline	dēsultorium -ī, n.
transplantation	trānslatio -ōnis, f.
trap-door	iānua dēcidua (v. cadūca) -ae, f.
treasury	aerārium (pūblicum) -ī, n.
treatise	commentātiō -ōnis, f.
tree-frog	calamītes -ae, f.
trot-noun	gradus citātus -ūs, m.
trout	tructa -ae, f.
trunk	manus nāsūta -ūs, f.
tug	remulcum -ī, n.
tugboat	scapha tractōria -ae, f.
turban	tiāra -ae, f.
turbulence	agitātiō -ōnis, f.
turkey	gallopāvo -ōnis, m.
turnstile	repāgulum -ī, n.
turtledove	turtur -uris, m.
tusk	dēns -entis, m.
type	typī -ōrum, m.
typesetter	compositor -ōris, m.
typo-in-printed-book	typothetae mendum -ī, n.
typographer	typographus ī, m.
typography	typographica ars -is, f.
ultraviolet-rays	radiī ultraviolacei -ōrum, m.
umbilical-cord	nervus umbilīcāris -ī, m.
underarm-hair	pili subālārēs -ōrum, m.
underarm-odor	ālārum sūdor -ōris, m.
unpublished-book	nōndum vulgātus -ī, m.
upper-jaw	maxilla superior -ae, f.
urea	urea -ae, f.
uvula	ūva -ae, f.
valve	spīrāmentum -ī, n.
variety-of-plant	cultivarietas -ātis, f.
vein	vēna -ae, f.
ventilation	ventilātio -ōnis, f.
ventilator	ventilābrum -ī, n.
ventricle	cordis ventriculus -ī, m.
vermillion	minium -ī, n.
vermouth	apsinthiātum -ī, n.
vertebra	vertēbra -ae, f.
vertebrate	animal vertēbrātum -ī, n.
vice-chancellor	procancellarius -ī, m.
vice-president	prōpraeses -idis, m.
vignette	emblēma -atis, n.
visor	ocularium -ī, n.
vivisection	vīvōrum sectio -ōnis, f.
vizir	vasīrus -ī, m.
vocal-chords	chordae vōcāles -ārum, f.
vodka	valida pōtiō Slavica -ōnis, f.
volleyball	follis volāticus -is, m.
volume	volūmen -inis, n.
vulture	vultur -uris, m.
wainscoting	abacī -ōrum, m.
waist	medium corpus -oris, n.
waistline	zōna -ae, f.
waiting-room	oecus profectiōnem praestōlāntium -ī, m.
walking-on-stilts	incessus grallatōrius -ūs, m.
wallet-billfold	bulgula -ae, f.
walls-half-timbered	parietes craticiī -um, m.
walrus	odobenus -ī, m.
warehouse	apothēca -ae, f.
warship	nāvis longa -is, f.
wart	verrūca -ae, f.
wasp	vespa -ae, f.
watch-dog	canis vigilāns (v. vigilax) -is, m.
water-polo	lūdus follis aquātilis -ī, m.
water-ski	narta aquātilis (v. aquātica) -ae, f.
watercolor	pictūra aquāria -ae, f.
weasel	mustēla -ae, f.
weed-killer	(venēnum) herbicidale -is, n.
weeds-pullingup	zizaniorum ēvulsio -onis, f.
weevil	curculiō -ōnis, m.
weissbier	zythus pallidum -ī, m.
whale	bālaena -ae, f.
whaler	piscātor bālaenarum -ōris, m.
whisker	saeta (vibrissa) -ae, f.
whisky	vischium -ī, n.
whistle	fistula signālis -ae, f.
wicket	portula -ae, f.
wildcat	lynx -yncis, m./f.
wind-surfer	vēlitabulātor -ōris, m.
window	portula -ae, f.
windpipe	artēria aspera -ae, f.
wine-press	torculum -ī, n.
wine-spritzer	vīnum aquatum (v. dilūtum) -ī, n.
wine-store	taberna vīnāria -ae, f.
wine-dry	vīnum austerum (v. asperum) -ī, n.
wine-fruit	vīnum pōmarium -ī, n.
wine-mulled	cal(i)dum -ī, n.
wine-new	vīnum hornotinum -ī, n.
wine-red	vīnum rubrum -ī, n.
wine-white	vīnum candidum -ī, n.
wolverine	gulo -ōnis, m.
womens-doubles	lūdus bis bīnārum mulierum -ī, m.
wood-golf	clāva lignea -ae, f.
woodcock	scolōpax -acis, f.
woodcut	imāgō xylographica -inis, f.
woodcutter	lignī sculptor -ōris, m.
woodenshoe	cūspus -ī, m.
woodpecker	pīcus -ī, m.
worldly	mundânus a um
worm	vermis -is, m.
wrestler	luctātor -ōris, m.
wrestling	luctātio -ōnis, f.
wrestling-match	luctāmen -inis, n.
wrist	prīma palmae pars -is, f.
writ-tissue-paper	papyrus fragilis -ī, f.
yacht	lembus (lūsōrius) -ī, m.
yard	antenna -ae, f.
zebra	zebra -ae, f.
zenith	verticale pūnctum -ī, n.
zodiac	orbis signifer -ī, m.
zoology	zōologia -ae, f.
zygote	zygōta -ae, f.
